N assets/roxo.xpm
W assets/roxo.xpm
E assets/roxo.xpm
S assets/roxo.xpm

C 202,21,104
F 121,100,70

111111111111111111111111
111111111111111111111111
110001111111111100d00011
1100011000000000e1100011
110S011e0000000001100011
1100011000000000e1100011
1100011e0000000001100011
110000001111111111100011
111111111111111111111111