1111111111111111111
1111111111111111111
11gg10000001e000011
11sg1e0000e10000e11
11e0e0011e010010011
110000e110010e1e011
110e11111e01001nn11
110011111001e01gg11
11e01ee00NN00e11111
1100e000eNg00011111
1100e001111e0e00011
110e00e111100000c11
1111111111111111111
1111111111111111111