11111111111111
11111111111111
111111gg111111
111111nn111111
11e0e0e0e0e011
11000000000011
11000000000e11
11e00000000011
11000000000011
110e0e0e0e0e11
111111rg111111
111111gg111111
11111111111111
11111111111111