1111111111111111111
1111111111111111111
11eeeeeeeee11111111
11eN0ee00ee11111111
11eNe000e0e11111111
11e0eeeee0e11111111
11e000cee0eeeeeee11
11eeeeeee000ee0oe11
11ene00e00e0e00ge11
11e000eeeeeeeeeee11
1111111111111111111
1111111111111111111