1111111111111111
1111111111111111
11e00011e00c1111
110r100001101111
1101101101101111
11e00011e0001111
110110110110ng11
110110110110ng11
11e00011e0001111
1101101101101111
1101101101101111
11c00011e00c1111
1111111111111111
1111111111111111