111111111111111111111111
111111111111111111111111
11111e0e0e0e0e0e0e111111
112220000000000000122211
12ggg000000c0000000ngg21
12ggg00000000000000ngg21
122220000000000000122221
111110e0e0e0e0e0e0111111
111111111111111111111111
111111111111111111111111