1111111111111
1111111111111
1111ggg1ggg11
1111sgg1ngg11
1111011101111
11110e1e01111
1111e010e1111
11110e1e01111
11e0001000e11
110e11111e011
1100e0e000011
11110e0e11111
1111111111111
1111111111111