111111111111111111111111
111111111111111111111111
11111c00000000000c111111
11111e0e0e0e0e0e0e111111
111110000000000000111111
11ggg00000000000000ngg11
11gpg00000000000000ngg11
111110000000000000111111
111110e0e0e0e0e0e0111111
11111c00000000000c111111
111111111111111111111111
111111111111111111111111