111111111111111111111111
122222111111111111222221
12ggg2111111111100dngg21
12ggg21000000000e12ggg21
12ggg21e00000000012ggg21
12ggg21000000000e12ggg21
12ggg21e00000000012ggg21
12gggg0011111111112ggg21
122222111111111111222221
111111111111111111111111