11111111
11111111
11c11111
11g11111
110eee11
11enre11
11egge11
11eeee11
11111111
11111111