1111111111111111111
1111111111111111111
111e0ece0e0e0e00111
111000000c000000111
11ge0e0e0e0e0e00n11
11t0000000000000n11
111e0ece0e0e0e00111
11100000000c0000111
1111111111111111111
1111111111111111111