111111111111111111111111
111111111111111111111111
11ggg1111111111100dngg11
11ggg11000000000e11ggg11
11ggg11e00000000011ggg11
11ggg11000000000e11ggg11
11gsg11e00000000011ggg11
11ggg00011111111111ggg11
111111111111111111111111
111111111111111111111111