N assets/wall.xpm
W assets/wall_o.xpm
E assets/wall_e.xpm
S assets/wall_s.xpm

C 202,21,104
F 121,20,80


    1111111111111111111111111111111
    1000000000110000010100000000001
    1000000000110000010101111101111
    10110111111111011110000010001
    11110001111111011101010010001
    11000000110101011100000010001
    10000000000000001100000010001
    10000000000000000001010010001
    11000001110101011111011110001
    11110111 111N101 101111010001
    11111111 1111111 111111111111