
N  assets/roxo.xpm

F 121,100,70

W   assets/roxo.xpm

E assets/roxo.xpm
S  assets/roxo.xpm

C 202,21,104


            111111111111111111111111111111111
            1000000000110010011100000000001
            100000000011000001110111111111111
            10110111111111011100000010001
            11110111111111d11101010010001
            11000e00110101011100000010001
            100000000000000e1100000010001
            10000000000ccc000001010010001
            110e00011101c101111101111000111
            11110111 111N101 101111010001
            11111111 1111111 111111111111