N assets/wall.xpm
W assets/wall_o.xpm
E assets/wall_e.xpm
S assets/wall_s.xpm

C 202,21,104
F 121,80,56


    1111111111111111111111111111111
    1000000000110000011100000000001
    1000000000110000011101111101111
    10110111111111011100000010001
    1111d111111111011101010010001
    11000000110101011100000010001
    10000000000000001100000010001
    10000000000000000001010010001
    11000001110101011111011110001
    11110111 111N101 101111010001
    11111111 1111111 111111111111